W W W W W W W W W W W W W W W W W
W E - - - - - H - - - - - - K - W
W - - - - - - C - - S - - - - - W
W - - - H - - - - - - - - - - - W
W - - - W - - S - - H - - - C - W
W - - W - - - - - - - - - - H - W
W - W - - - C - - W W W - - - - W
W - - - - - - - - H - - - - - - W
W - - - H - - - - - - - - - - - W
W - - - H - - - - - C - - - - - W
W - C - H - - - - - - - - - - - W
W C C C - - - - - - - - C - P - W
W W W W W W W W W W W W W W W W W