W W W W W W W W W W W W W W W W W
W E - - - - - - - - - - - - - - W
W - - B - - - - - - S - - - - - W
W - - - H - - - - - - - - - - - W
W - - - W - - S - - - - - - - - W
W - - W - - - - - - - - - - - - W
W - W - - - - - - W W W - - - - W
W - - - - - - - - - - - - - - - W
W - - - - - - - - - - - - - - - W
W - - - - - - B - - - - - - - - W
W - - - - - - - - - - - - - - - W
W - - - - - - - - - - - - - P - W
W W W W W W W W W W W W W W W W W